********************************
*                              *
*                              *
*                              *
*                              *
*         *          *         *
*         *          *         *
*         *          *         *
*                              *
*           ********           *
*                              *
*                              *
*                              *
*   *********      *********   *
*                              *
*                              *
*                              *
*                              *
*          **********          *
*                              *
*                              *
*                              *
*              **              *
*   *          **          *   *
*   *          **          *   *
*   *                      *   *
* *****                  ***** *
* *                          * *
* *                          * *
*                              *
*                              *
**************     *************
