********************************
*                              *
*                              *
*                              *
*                              *
*                              *
*                              *
*                              *
*                              *
*                              *
*                              *
*         ***      ****        *
*         *           *        *
*         *           *        *
*         *           *        *
*         *           *        *
*                              *
*                              *
*         *  *  *  *  *        *
*                              *
*                              *
*                              *
*         *************        *
*                              *
*                              *
*                              *
*                              *
*                              *
*                              *
*                              *
*                              *
********************************
