********************************
*                              *
*                              *
*                              *
*                              *
*                              *
*                              *
*                              *
*                              *
*                              *
*                              *
*                              *
*         *           *        *
*         *           *        *
*         *           *        *
*         *           *        *
*                              *
*                              *
*         *  *  *  *  *        *
*                              *
*                              *
*                              *
*         ************         *
*                              *
*                              *
*                              *
*                              *
*                              *
*                              *
*                              *
*                              *
********************************
