********************************
*                              *
*                              *
*                              *
*                              *
*                              *
*                              *
*                              *
*                  *           *
*                 *            *
*                *     *       *
*               *      *       *
*              *       *       *
*             *        *       *
*            *         *       *
*           *          *       *
*            ***********       *
*                              *
*                              *
*                              *
*                              *
*                              *
*                              *
*                              *
*                              *
*                              *
*                              *
*                              *
*                              *
*                              *
*                              *
********************************
