********************************
*                              *
*                              *
*                              *
*                              *
*                              *
*                    *         *
*                     *        *
*                      *       *
*                              *
*                              *
*                              *
*                              *
*                              *
*                              *
*                              *
*                              *
*                              *
*                              *
*                              *
*       *                      *
*        *                     *
*         *                    *
*                              *
*                              *
*                              *
*                              *
*                              *
*                              *
*                              *
*                              *
********************************
