********************************
*                              *
*                              *
*                              *
*                     *        *
*                              *
*                              *
*                              *
*                            * *
*                              *
*                              *
*                              *
*                              *
*                              *
*                              *
*                              *
*                              *
*                              *
*                              *
*                              *
*                              *
*                              *
*                              *
*                              *
*                              *
*                              *
*                              *
*                              *
*                              *
*                              *
*                              *
********************************
