********************************
*                              *
*                              *
*                              *
*                              *
*         *          *         *
*         *          *         *
*                              *
*      *    ********    *      *
*      *                *      *
*      *                *      *
*                              *
*           *      *           *
*   *   ******    ******   *   *
*   *                      *   *
*   *          **          *   *
*   *          **          *   *
*             ****             *
*                              *
*         ****    ****         *
*          ****  ****          *
*           ********           *
*            ******            *
*   *         ****         *   *
*   *          **          *   *
*   *                      *   *
* *****                  ***** *
* *                          * *
* *                          * *
*                              *
*                              *
**************     *************
