********************************
*                              *
*                              *
*                              *
*                              *
*                              *
*                              *
*                              *
*                              *
*                **            *
*                 **           *
*                  **          *
*                   **          
*                    **         
*                   **          
*                  **           
*                 **            
*                **            *
*                              *
*                              *
*                              *
*                              *
*                              *
*                              *
*                              *
*                              *
*                              *
*                              *
*                              *
*                              *
*                              *
********************************
